5 10 2
|--------|
|F.|...F.|
|..|@.|..|
|.....|..|
|--------|
