8 14 2
|------------|
|P.|...F.....|
|..|@P|......|
|...F.|......|
|............|
|.....|......|
|............|
|------------|