5 10
|--------|
|..|.....|
|..|@.|..|
|.....|..|
|--------|